111111111111111
100100010000111
1000000C0000001
100E00000011111
111100000000001
100000001000111
1000000100000N1
1000P0010000011
100100100100001
111111111111111
